###################
#.................#
#.####.##.##.####.#
#...#..##.##..#...#
#.###..##.##..###.#
#.#...###.###...#.#
#....####.####....#
#.#####.....#####.#
#.#####.###.#####.#
#.......#.#.......#
#.#####.###.#####.#
#.#####.....#####.#
#....####.####....#
#.#...###.###...#.#
#.###..##.##..###.#
#.#.#..##.##..###.#
#.#.##.##.##.##.#.#
#.................#
###################