15
13 
###############
#.............#
#.#.#.#.#.#.#.#
#..w.......w..#
#.#.#.#.#.#.#.#
#.............#
#.#.#.#.#.#.#.#
#.............#
#.#.#.#.#.#.#.#
#..w.......w..#
#.#.#.#.#.#.#.#
#.............#
###############