15
13 
###############
#.#...........#
#.............#
#.............#
#.............#
#.............#
#.............#
#.............#
#.............#
#.............#
#.............#
#.............#
###############